0,72,92,111,124,149,79,57,141
72,0,75,79,30,124,106,81,164
92,75,0,94,89,101,67,34,85
111,79,94,0,132,40,130,123,134
124,30,89,132,0,145,60,165,76
149,124,101,40,145,0,89,71,99
79,106,67,130,60,89,0,81,77
57,81,34,123,165,71,81,0,144
141,164,85,134,76,99,77,144,0
