0,104,95,80,101,174,86,114,75,82
104,0,140,32,80,78,110,90,88,59
95,140,0,38,127,83,115,103,151,108
80,32,38,0,78,77,154,124,98,144
101,80,127,78,0,137,62,133,50,106
174,78,83,77,137,0,90,105,94,116
86,110,115,154,62,90,0,46,33,115
114,90,103,124,133,105,46,0,106,114
75,88,151,98,50,94,33,106,0,131
82,59,108,144,106,116,115,114,131,0
