0,158,77,87,126,121,130,67
158,0,144,13,22,176,145,110
77,144,0,149,179,142,97,93
87,13,149,0,126,125,25,109
126,22,179,126,0,133,116,19
121,176,142,125,133,0,126,129
130,145,97,25,116,126,0,107
67,110,93,109,19,129,107,0
