0,140,137,114,42,99,36,123,128,163,64
140,0,120,152,139,154,24,105,104,158,111
137,120,0,86,146,117,138,165,30,150,24
114,152,86,0,99,96,72,122,163,74,91
42,139,146,99,0,71,168,185,117,59,57
99,154,117,96,71,0,46,122,146,70,119
36,24,138,72,168,46,0,132,114,97,105
123,105,165,122,185,122,132,0,53,143,159
128,104,30,163,117,146,114,53,0,130,31
163,158,150,74,59,70,97,143,130,0,187
64,111,24,91,57,119,105,159,31,187,0
