0,66,85,43,77,48,36,119,132
66,0,49,88,54,154,45,42,99
85,49,0,53,147,18,118,52,56
43,88,53,0,150,136,98,115,60
77,54,147,150,0,81,73,73,12
48,154,18,136,81,0,99,107,106
36,45,118,98,73,99,0,182,112
119,42,52,115,73,107,182,0,159
132,99,56,60,12,106,112,159,0
