0,99,63,85,79,123,71,131,147
99,0,127,41,32,64,97,77,105
63,127,0,123,53,165,49,128,89
85,41,123,0,99,139,149,9,99
79,32,53,99,0,159,107,181,162
123,64,165,139,159,0,60,52,152
71,97,49,149,107,60,0,74,111
131,77,128,9,181,52,74,0,83
147,105,89,99,162,152,111,83,0
