0,145,190,102,135,173,131,132,63,92,71,18
145,0,32,107,136,149,146,136,84,134,38,103
190,32,0,54,84,133,165,163,44,120,67,53
102,107,54,0,33,97,159,72,99,20,147,99
135,136,84,33,0,91,117,98,98,176,136,22
173,149,133,97,91,0,150,81,66,48,155,100
131,146,165,159,117,150,0,138,101,152,51,51
132,136,163,72,98,81,138,0,113,114,148,96
63,84,44,99,98,66,101,113,0,43,145,37
92,134,120,20,176,48,152,114,43,0,118,97
71,38,67,147,136,155,51,148,145,118,0,180
18,103,53,99,22,100,51,96,37,97,180,0
