0,175,132,128,101,75,12,95,99
175,0,83,100,63,140,51,114,102
132,83,0,128,74,55,117,184,93
128,100,128,0,98,122,99,95,103
101,63,74,98,0,119,93,90,33
75,140,55,122,119,0,71,178,90
12,51,117,99,93,71,0,106,61
95,114,184,95,90,178,106,0,92
99,102,93,103,33,90,61,92,0
