0,85,122,126,76,162,132,130,36,125
85,0,186,26,98,131,100,119,160,67
122,186,0,36,37,48,166,63,91,107
126,26,36,0,174,50,19,32,149,155
76,98,37,174,0,88,71,81,154,88
162,131,48,50,88,0,83,114,152,45
132,100,166,19,71,83,0,97,91,158
130,119,63,32,81,114,97,0,91,108
36,160,91,149,154,152,91,91,0,68
125,67,107,155,88,45,158,108,68,0
