0,57,127,136,141,69,38,59,103
57,0,56,103,123,23,99,91,45
127,56,0,137,47,105,172,53,64
136,103,137,0,177,34,118,68,75
141,123,47,177,0,109,109,174,83
69,23,105,34,109,0,19,90,49
38,99,172,118,109,19,0,150,155
59,91,53,68,174,90,150,0,120
103,45,64,75,83,49,155,120,0
