0,27,97,73,33,111,33,83,106,122
27,0,102,119,115,80,83,40,37,34
97,102,0,116,75,138,109,117,103,98
73,119,116,0,109,151,62,71,111,139
33,115,75,109,0,89,136,142,94,38
111,80,138,151,89,0,148,184,153,114
33,83,109,62,136,148,0,141,80,134
83,40,117,71,142,184,141,0,110,37
106,37,103,111,94,153,80,110,0,90
122,34,98,139,38,114,134,37,90,0
