0,144,176,90,107,106,84,118,68,51
144,0,67,124,105,77,16,110,47,91
176,67,0,147,50,133,28,107,91,28
90,124,147,0,21,79,80,72,127,96
107,105,50,21,0,122,177,52,122,176
106,77,133,79,122,0,133,21,69,109
84,16,28,80,177,133,0,96,107,71
118,110,107,72,52,21,96,0,108,94
68,47,91,127,122,69,107,108,0,101
51,91,28,96,176,109,71,94,101,0
