0,110,73,93,112,69,67,98,16,119,164
110,0,102,58,42,115,108,62,179,93,144
73,102,0,60,127,134,109,132,65,118,63
93,58,60,0,150,80,145,78,143,51,126
112,42,127,150,0,72,104,147,54,114,55
69,115,134,80,72,0,114,192,105,51,134
67,108,109,145,104,114,0,28,148,6,63
98,62,132,78,147,192,28,0,168,109,131
16,179,65,143,54,105,148,168,0,64,148
119,93,118,51,114,51,6,109,64,0,165
164,144,63,126,55,134,63,131,148,165,0
