0,136,63,52,50,143,49,50,126,147,102
136,0,104,117,132,27,82,160,182,88,129
63,104,0,129,130,92,70,153,41,82,120
52,117,129,0,104,111,97,38,112,82,78
50,132,130,104,0,105,62,161,133,47,76
143,27,92,111,105,0,169,57,193,47,71
49,82,70,97,62,169,0,53,82,139,144
50,160,153,38,161,57,53,0,3,78,135
126,182,41,112,133,193,82,3,0,76,21
147,88,82,82,47,47,139,78,76,0,88
102,129,120,78,76,71,144,135,21,88,0
