0,131,77,92,106,67,136,50,128,22
131,0,53,75,61,22,87,128,146,152
77,53,0,159,158,22,151,115,140,152
92,75,159,0,116,124,96,24,76,45
106,61,158,116,0,97,48,68,89,66
67,22,22,124,97,0,112,71,117,70
136,87,151,96,48,112,0,115,113,178
50,128,115,24,68,71,115,0,135,87
128,146,140,76,89,117,113,135,0,143
22,152,152,45,66,70,178,87,143,0
