0,161,121,63,183,18,130,90,173,93,128,89
161,0,135,146,43,136,58,65,72,64,157,123
121,135,0,126,115,110,129,135,103,44,94,136
63,146,126,0,146,71,114,104,124,172,163,71
183,43,115,146,0,69,99,112,103,71,75,132
18,136,110,71,69,0,98,149,136,104,84,75
130,58,129,114,99,98,0,89,80,104,18,110
90,65,135,104,112,149,89,0,130,49,97,40
173,72,103,124,103,136,80,130,0,46,94,168
93,64,44,172,71,104,104,49,46,0,91,162
128,157,94,163,75,84,18,97,94,91,0,114
89,123,136,71,132,75,110,40,168,162,114,0
