0,177,100,125,98,82,159,160
177,0,138,156,146,68,97,92
100,138,0,54,129,190,114,120
125,156,54,0,71,125,77,60
98,146,129,71,0,98,133,106
82,68,190,125,98,0,121,96
159,97,114,77,133,121,0,33
160,92,120,60,106,96,33,0
