0,144,100,167,105,54,58,118,156,117
144,0,90,139,95,11,176,99,74,65
100,90,0,126,85,14,93,86,98,94
167,139,126,0,80,50,124,149,105,112
105,95,85,80,0,159,125,93,171,98
54,11,14,50,159,0,54,98,66,87
58,176,93,124,125,54,0,93,120,77
118,99,86,149,93,98,93,0,45,43
156,74,98,105,171,66,120,45,0,154
117,65,94,112,98,87,77,43,154,0
