0,81,62,146,100,143,79,18,70
81,0,139,86,104,31,137,76,151
62,139,0,42,179,60,146,138,128
146,86,42,0,100,102,101,33,117
100,104,179,100,0,62,26,72,93
143,31,60,102,62,0,67,88,79
79,137,146,101,26,67,0,139,102
18,76,138,33,72,88,139,0,94
70,151,128,117,93,79,102,94,0
