0,175,118,117,57,62,97,197,118,165,127,59
175,0,160,64,70,108,96,65,85,45,165,76
118,160,0,41,55,84,80,83,73,65,72,97
117,64,41,0,145,85,100,101,113,115,75,51
57,70,55,145,0,60,41,113,55,118,146,115
62,108,84,85,60,0,98,134,122,148,169,169
97,96,80,100,41,98,0,64,136,94,22,51
197,65,83,101,113,134,64,0,56,132,57,111
118,85,73,113,55,122,136,56,0,183,189,122
165,45,65,115,118,148,94,132,183,0,148,55
127,165,72,75,146,169,22,57,189,148,0,168
59,76,97,51,115,169,51,111,122,55,168,0
