0,113,133,106,117,69,75,103,63,195
113,0,114,109,110,90,103,120,74,113
133,114,0,111,52,76,50,126,133,126
106,109,111,0,69,179,158,106,65,80
117,110,52,69,0,129,112,76,122,83
69,90,76,179,129,0,79,116,126,71
75,103,50,158,112,79,0,87,127,167
103,120,126,106,76,116,87,0,116,60
63,74,133,65,122,126,127,116,0,189
195,113,126,80,83,71,167,60,189,0
