0,59,169,143,75,51,86,173,67
59,0,83,102,184,53,45,120,125
169,83,0,122,88,78,90,102,91
143,102,122,0,111,80,154,124,98
75,184,88,111,0,156,141,159,77
51,53,78,80,156,0,58,62,99
86,45,90,154,141,58,0,98,164
173,120,102,124,159,62,98,0,58
67,125,91,98,77,99,164,58,0
