0,66,94,112,104,43,102,60,51
66,0,125,116,47,61,76,128,22
94,125,0,171,74,107,84,89,97
112,116,171,0,126,50,88,166,115
104,47,74,126,0,126,79,109,118
43,61,107,50,126,0,79,124,112
102,76,84,88,79,79,0,110,100
60,128,89,166,109,124,110,0,147
51,22,97,115,118,112,100,147,0
