0,181,90,105,89,101,87,24
181,0,91,74,136,93,140,14
90,91,0,103,124,90,42,77
105,74,103,0,47,121,130,82
89,136,124,47,0,163,111,74
101,93,90,121,163,0,141,154
87,140,42,130,111,141,0,27
24,14,77,82,74,154,27,0
