0,130,115,118,150,96,111,88
130,0,162,151,194,31,148,69
115,162,0,116,81,47,119,135
118,151,116,0,84,183,100,106
150,194,81,84,0,165,132,99
96,31,47,183,165,0,101,145
111,148,119,100,132,101,0,132
88,69,135,106,99,145,132,0
