0,23,47,134,105,85,29,11,69,145,41
23,0,128,128,178,79,37,152,91,55,96
47,128,0,132,90,171,155,146,95,20,137
134,128,132,0,150,163,78,46,124,87,94
105,178,90,150,0,43,92,120,115,20,28
85,79,171,163,43,0,104,120,89,117,130
29,37,155,78,92,104,0,94,158,143,126
11,152,146,46,120,120,94,0,88,119,66
69,91,95,124,115,89,158,88,0,91,137
145,55,20,87,20,117,143,119,91,0,171
41,96,137,94,28,130,126,66,137,171,0
