0,174,131,42,95,149,18,147,145,110,127,106
174,0,96,181,125,96,88,117,96,81,73,74
131,96,0,97,97,96,98,115,77,159,99,114
42,181,97,0,35,121,87,61,75,127,44,84
95,125,97,35,0,119,35,90,53,26,99,101
149,96,96,121,119,0,80,102,182,94,85,112
18,88,98,87,35,80,0,77,112,26,102,81
147,117,115,61,90,102,77,0,101,125,98,126
145,96,77,75,53,182,112,101,0,113,134,82
110,81,159,127,26,94,26,125,113,0,154,90
127,73,99,44,99,85,102,98,134,154,0,89
106,74,114,84,101,112,81,126,82,90,89,0
