0,116,84,167,60,57,167,143,60,103,67
116,0,104,71,88,128,104,88,140,105,122
84,104,0,119,80,106,97,149,28,153,94
167,71,119,0,163,80,62,133,144,68,180
60,88,80,163,0,72,49,147,98,43,63
57,128,106,80,72,0,96,104,147,48,139
167,104,97,62,49,96,0,48,113,165,142
143,88,149,133,147,104,48,0,51,167,132
60,140,28,144,98,147,113,51,0,49,103
103,105,153,68,43,48,165,167,49,0,60
67,122,94,180,63,139,142,132,103,60,0
