0,126,98,132,110,58,134,132
126,0,131,148,29,37,47,150
98,131,0,134,50,82,129,64
132,148,134,0,70,123,166,101
110,29,50,70,0,168,95,147
58,37,82,123,168,0,102,77
134,47,129,166,95,102,0,53
132,150,64,101,147,77,53,0
