0,126,42,107,107,57,121,55,54,171,156,82
126,0,100,119,93,77,82,151,94,127,118,108
42,100,0,106,88,169,24,152,53,172,121,71
107,119,106,0,73,109,134,131,104,54,29,122
107,93,88,73,0,37,126,128,119,130,111,78
57,77,169,109,37,0,52,107,75,60,118,84
121,82,24,134,126,52,0,120,156,128,133,83
55,151,152,131,128,107,120,0,59,127,163,106
54,94,53,104,119,75,156,59,0,29,103,9
171,127,172,54,130,60,128,127,29,0,90,108
156,118,121,29,111,118,133,163,103,90,0,150
82,108,71,122,78,84,83,106,9,108,150,0
