0,160,9,103,75,67,47,11,181
160,0,75,105,70,40,99,145,56
9,75,0,85,83,161,111,104,82
103,105,85,0,68,50,111,117,132
75,70,83,68,0,118,64,152,124
67,40,161,50,118,0,127,105,91
47,99,111,111,64,127,0,115,35
11,145,104,117,152,105,115,0,191
181,56,82,132,124,91,35,191,0
