0,119,126,98,74,123,45,80
119,0,120,5,36,118,120,56
126,120,0,115,148,87,79,50
98,5,115,0,111,67,79,147
74,36,148,111,0,103,177,144
123,118,87,67,103,0,135,89
45,120,79,79,177,135,0,91
80,56,50,147,144,89,91,0
