0,110,45,91,94,128,37,111,147,123,92,135
110,0,144,126,64,72,87,54,62,115,159,69
45,144,0,190,77,54,53,102,107,97,177,101
91,126,190,0,122,57,166,18,143,124,88,88
94,64,77,122,0,68,5,91,162,86,102,45
128,72,54,57,68,0,95,75,97,133,171,105
37,87,53,166,5,95,0,46,92,155,138,24
111,54,102,18,91,75,46,0,147,30,125,86
147,62,107,143,162,97,92,147,0,53,124,128
123,115,97,124,86,133,155,30,53,0,127,160
92,159,177,88,102,171,138,125,124,127,0,144
135,69,101,88,45,105,24,86,128,160,144,0
