0,43,151,62,66,59,147,130,68,84,100,115
43,0,67,61,148,102,120,42,96,82,145,88
151,67,0,127,23,154,52,76,53,92,98,42
62,61,127,0,115,71,101,130,52,116,109,183
66,148,23,115,0,125,152,96,59,114,103,88
59,102,154,71,125,0,86,10,90,153,14,61
147,120,52,101,152,86,0,139,23,127,111,141
130,42,76,130,96,10,139,0,104,131,59,76
68,96,53,52,59,90,23,104,0,97,57,92
84,82,92,116,114,153,127,131,97,0,23,76
100,145,98,109,103,14,111,59,57,23,0,158
115,88,42,183,88,61,141,76,92,76,158,0
