0,127,64,35,144,54,48,104,184
127,0,74,40,17,24,72,141,7
64,74,0,185,118,72,145,170,115
35,40,185,0,80,94,15,118,165
144,17,118,80,0,113,27,160,146
54,24,72,94,113,0,79,45,187
48,72,145,15,27,79,0,96,81
104,141,170,118,160,45,96,0,79
184,7,115,165,146,187,81,79,0
