0,175,44,67,171,175,114,75
175,0,113,87,34,125,139,60
44,113,0,106,59,98,60,127
67,87,106,0,96,108,99,115
171,34,59,96,0,43,180,118
175,125,98,108,43,0,127,97
114,139,60,99,180,127,0,42
75,60,127,115,118,97,42,0
