0,93,113,101,148,76,123,127
93,0,139,98,164,45,88,40
113,139,0,125,73,130,158,109
101,98,125,0,144,29,116,111
148,164,73,144,0,41,136,177
76,45,130,29,41,0,97,41
123,88,158,116,136,97,0,118
127,40,109,111,177,41,118,0
