0,140,120,123,130,154,88,60,139,81,96,139
140,0,106,127,53,76,147,109,56,66,71,105
120,106,0,41,75,71,146,121,146,68,115,35
123,127,41,0,80,126,28,64,134,143,118,110
130,53,75,80,0,110,165,95,114,90,128,108
154,76,71,126,110,0,72,74,154,87,54,96
88,147,146,28,165,72,0,72,9,172,140,111
60,109,121,64,95,74,72,0,152,177,159,101
139,56,146,134,114,154,9,152,0,78,84,151
81,66,68,143,90,87,172,177,78,0,101,116
96,71,115,118,128,54,140,159,84,101,0,120
139,105,35,110,108,96,111,101,151,116,120,0
