0,56,127,19,98,148,122,132,125,159,41
56,0,115,98,119,161,57,21,97,58,73
127,115,0,115,81,193,100,106,109,111,144
19,98,115,0,114,86,19,135,66,23,19
98,119,81,114,0,126,166,125,126,106,103
148,161,193,86,126,0,109,107,83,144,90
122,57,100,19,166,109,0,140,172,128,156
132,21,106,135,125,107,140,0,71,85,122
125,97,109,66,126,83,172,71,0,78,21
159,58,111,23,106,144,128,85,78,0,64
41,73,144,19,103,90,156,122,21,64,0
