0,12,86,58,155,71,135,146,48,75,79,65
12,0,125,79,80,88,123,63,79,126,148,179
86,125,0,29,114,36,123,135,124,115,111,82
58,79,29,0,161,107,137,81,66,68,93,90
155,80,114,161,0,58,165,97,112,108,45,129
71,88,36,107,58,0,24,91,138,154,111,92
135,123,123,137,165,24,0,91,27,99,85,12
146,63,135,81,97,91,91,0,59,102,52,54
48,79,124,66,112,138,27,59,0,122,84,90
75,126,115,68,108,154,99,102,122,0,107,111
79,148,111,93,45,111,85,52,84,107,0,167
65,179,82,90,129,92,12,54,90,111,167,0
