0,50,34,121,148,98,149,124,128,167,130
50,0,29,4,104,100,29,76,155,154,21
34,29,0,157,191,153,75,143,134,31,112
121,4,157,0,147,64,97,99,51,57,77
148,104,191,147,0,79,76,110,90,20,122
98,100,153,64,79,0,93,146,95,110,102
149,29,75,97,76,93,0,103,82,163,84
124,76,143,99,110,146,103,0,92,127,98
128,155,134,51,90,95,82,92,0,65,59
167,154,31,57,20,110,163,127,65,0,53
130,21,112,77,122,102,84,98,59,53,0
