0,68,42,81,124,177,120,25
68,0,156,60,119,114,138,118
42,156,0,124,162,141,60,29
81,60,124,0,112,114,135,117
124,119,162,112,0,89,30,135
177,114,141,114,89,0,161,112
120,138,60,135,30,161,0,153
25,118,29,117,135,112,153,0
