0,142,93,156,124,110,82,152,94
142,0,44,71,114,171,136,176,120
93,44,0,117,129,129,11,74,131
156,71,117,0,146,55,109,133,130
124,114,129,146,0,40,106,90,158
110,171,129,55,40,0,196,156,143
82,136,11,109,106,196,0,96,165
152,176,74,133,90,156,96,0,148
94,120,131,130,158,143,165,148,0
