0,138,17,54,43,64,120,105,56
138,0,83,100,113,133,108,104,96
17,83,0,129,112,101,113,105,20
54,100,129,0,133,33,68,126,38
43,113,112,133,0,46,97,57,76
64,133,101,33,46,0,76,48,160
120,108,113,68,97,76,0,102,16
105,104,105,126,57,48,102,0,76
56,96,20,38,76,160,16,76,0
