0,115,85,65,100,110,96,84,42,66,66
115,0,128,167,145,141,41,75,157,159,113
85,128,0,19,116,140,122,125,122,119,141
65,167,19,0,118,89,114,157,140,53,45
100,145,116,118,0,111,61,82,178,120,159
110,141,140,89,111,0,46,160,129,147,181
96,41,122,114,61,46,0,162,77,101,117
84,75,125,157,82,160,162,0,32,176,90
42,157,122,140,178,129,77,32,0,68,161
66,159,119,53,120,147,101,176,68,0,106
66,113,141,45,159,181,117,90,161,106,0
