0,81,68,85,108,164,131,56,150,96
81,0,82,172,162,75,157,122,71,86
68,82,0,99,132,60,166,73,42,77
85,172,99,0,178,63,100,106,163,147
108,162,132,178,0,8,161,110,93,150
164,75,60,63,8,0,140,79,134,131
131,157,166,100,161,140,0,154,128,76
56,122,73,106,110,79,154,0,66,56
150,71,42,163,93,134,128,66,0,94
96,86,77,147,150,131,76,56,94,0
