0,33,56,154,77,40,72,119,102,100
33,0,16,39,82,83,100,123,70,85
56,16,0,132,51,62,54,148,105,77
154,39,132,0,111,89,193,71,118,150
77,82,51,111,0,123,162,66,132,93
40,83,62,89,123,0,43,93,98,126
72,100,54,193,162,43,0,151,71,96
119,123,148,71,66,93,151,0,47,105
102,70,105,118,132,98,71,47,0,196
100,85,77,150,93,126,96,105,196,0
