0,109,97,133,92,174,95,65
109,0,114,152,27,186,114,119
97,114,0,137,32,177,97,102
133,152,137,0,130,50,83,112
92,27,32,130,0,118,119,84
174,186,177,50,118,0,72,92
95,114,97,83,119,72,0,115
65,119,102,112,84,92,115,0
