0,124,132,129,142,168,72,101,123,26,138
124,0,154,77,83,90,135,119,174,117,64
132,154,0,103,69,142,105,53,23,106,184
129,77,103,0,100,140,26,51,100,110,102
142,83,69,100,0,176,159,119,76,137,147
168,90,142,140,176,0,128,123,51,72,142
72,135,105,26,159,128,0,39,109,104,27
101,119,53,51,119,123,39,0,118,81,175
123,174,23,100,76,51,109,118,0,54,140
26,117,106,110,137,72,104,81,54,0,109
138,64,184,102,147,142,27,175,140,109,0
