0,88,148,120,121,148,103,176
88,0,141,96,93,93,26,73
148,141,0,42,171,89,133,48
120,96,42,0,94,76,77,101
121,93,171,94,0,98,70,74
148,93,89,76,98,0,15,88
103,26,133,77,70,15,0,120
176,73,48,101,74,88,120,0
