0,91,78,49,46,96,161,67,71,38
91,0,124,101,192,47,118,185,65,87
78,124,0,110,141,142,61,99,106,67
49,101,110,0,129,70,132,167,66,119
46,192,141,129,0,113,110,102,96,64
96,47,142,70,113,0,138,52,132,70
161,118,61,132,110,138,0,126,171,164
67,185,99,167,102,52,126,0,31,165
71,65,106,66,96,132,171,31,0,27
38,87,67,119,64,70,164,165,27,0
