0,161,122,129,42,67,166,78,122,33,88
161,0,34,96,61,72,60,107,106,36,28
122,34,0,32,80,79,118,90,185,118,130
129,96,32,0,106,131,131,163,64,115,106
42,61,80,106,0,112,111,188,172,65,59
67,72,79,131,112,0,42,141,123,96,78
166,60,118,131,111,42,0,94,119,137,117
78,107,90,163,188,141,94,0,39,84,165
122,106,185,64,172,123,119,39,0,190,99
33,36,118,115,65,96,137,84,190,0,140
88,28,130,106,59,78,117,165,99,140,0
