0,112,139,73,70,75,51,103,78,133,100,48
112,0,63,116,17,100,126,118,71,58,155,108
139,63,0,34,158,107,136,80,101,109,128,100
73,116,34,0,104,91,169,77,160,113,174,80
70,17,158,104,0,48,107,90,102,113,49,55
75,100,107,91,48,0,91,25,63,137,136,134
51,126,136,169,107,91,0,108,95,137,152,38
103,118,80,77,90,25,108,0,124,94,120,47
78,71,101,160,102,63,95,124,0,137,129,118
133,58,109,113,113,137,137,94,137,0,122,34
100,155,128,174,49,136,152,120,129,122,0,83
48,108,100,80,55,134,38,47,118,34,83,0
