0,125,26,84,95,101,80,70,81,106
125,0,142,148,88,66,157,56,43,45
26,142,0,142,83,88,106,84,75,72
84,148,142,0,166,15,62,117,118,38
95,88,83,166,0,113,126,52,181,41
101,66,88,15,113,0,38,37,6,116
80,157,106,62,126,38,0,110,66,160
70,56,84,117,52,37,110,0,120,68
81,43,75,118,181,6,66,120,0,116
106,45,72,38,41,116,160,68,116,0
