0,56,42,167,67,158,27,115
56,0,133,55,84,137,132,38
42,133,0,113,53,40,175,77
167,55,113,0,101,174,76,99
67,84,53,101,0,59,159,110
158,137,40,174,59,0,151,174
27,132,175,76,159,151,0,42
115,38,77,99,110,174,42,0
