0,131,95,99,20,132,129,127,145
131,0,165,59,79,105,158,80,161
95,165,0,94,101,36,147,87,160
99,59,94,0,117,120,30,137,43
20,79,101,117,0,83,73,29,94
132,105,36,120,83,0,123,107,146
129,158,147,30,73,123,0,75,77
127,80,87,137,29,107,75,0,37
145,161,160,43,94,146,77,37,0
