0,74,100,136,39,80,105,113,107,153,58
74,0,147,104,176,168,101,22,53,102,122
100,147,0,103,137,40,142,109,76,44,27
136,104,103,0,150,73,14,122,121,133,113
39,176,137,150,0,57,132,21,114,94,48
80,168,40,73,57,0,172,21,103,161,17
105,101,142,14,132,172,0,110,121,44,71
113,22,109,122,21,21,110,0,148,115,48
107,53,76,121,114,103,121,148,0,140,50
153,102,44,133,94,161,44,115,140,0,89
58,122,27,113,48,17,71,48,50,89,0
