0,105,56,137,119,143,101,174,163,42,69
105,0,61,44,83,63,148,89,103,50,109
56,61,0,106,105,22,174,182,26,109,149
137,44,106,0,156,70,54,126,105,119,99
119,83,105,156,0,133,123,145,104,74,87
143,63,22,70,133,0,96,155,92,130,96
101,148,174,54,123,96,0,107,166,164,139
174,89,182,126,145,155,107,0,73,55,142
163,103,26,105,104,92,166,73,0,104,19
42,50,109,119,74,130,164,55,104,0,4
69,109,149,99,87,96,139,142,19,4,0
