0,117,131,78,34,161,57,99,138,159,65,103
117,0,134,154,14,46,106,99,111,54,91,136
131,134,0,89,132,115,75,20,103,105,182,131
78,154,89,0,20,119,65,26,124,95,56,88
34,14,132,20,0,64,125,19,61,96,78,62
161,46,115,119,64,0,73,101,164,29,154,118
57,106,75,65,125,73,0,121,109,103,67,70
99,99,20,26,19,101,121,0,166,56,57,64
138,111,103,124,61,164,109,166,0,128,88,74
159,54,105,95,96,29,103,56,128,0,105,102
65,91,182,56,78,154,67,57,88,105,0,140
103,136,131,88,62,118,70,64,74,102,140,0
