0,83,20,93,81,21,100,133
83,0,75,23,73,99,163,113
20,75,0,156,131,94,49,40
93,23,156,0,40,158,41,40
81,73,131,40,0,94,128,23
21,99,94,158,94,0,22,47
100,163,49,41,128,22,0,109
133,113,40,40,23,47,109,0
