0,127,180,21,123,120,102,93,139,98,110
127,0,69,59,133,74,92,40,49,60,48
180,69,0,102,72,137,87,46,121,153,137
21,59,102,0,21,94,154,65,146,105,78
123,133,72,21,0,155,97,63,62,130,91
120,74,137,94,155,0,25,73,115,175,54
102,92,87,154,97,25,0,98,74,92,119
93,40,46,65,63,73,98,0,34,107,76
139,49,121,146,62,115,74,34,0,120,28
98,60,153,105,130,175,92,107,120,0,86
110,48,137,78,91,54,119,76,28,86,0
