0,81,98,85,185,91,159,51,82,114
81,0,60,90,88,159,119,44,15,58
98,60,0,177,77,105,131,44,82,118
85,90,177,0,103,32,89,96,60,98
185,88,77,103,0,66,32,67,135,102
91,159,105,32,66,0,105,38,78,119
159,119,131,89,32,105,0,82,108,130
51,44,44,96,67,38,82,0,140,135
82,15,82,60,135,78,108,140,0,108
114,58,118,98,102,119,130,135,108,0
