0,102,88,125,68,53,81,122,123,66,83
102,0,59,95,51,142,162,143,140,155,79
88,59,0,97,65,124,106,111,115,84,119
125,95,97,0,57,85,57,26,143,72,102
68,51,65,57,0,132,55,50,97,127,189
53,142,124,85,132,0,127,48,53,79,99
81,162,106,57,55,127,0,48,142,58,67
122,143,111,26,50,48,48,0,104,78,110
123,140,115,143,97,53,142,104,0,8,191
66,155,84,72,127,79,58,78,8,0,44
83,79,119,102,189,99,67,110,191,44,0
