0,13,92,93,125,146,18,47,109,107,160,145
13,0,142,65,64,139,87,159,171,127,106,58
92,142,0,19,113,52,89,86,67,79,138,87
93,65,19,0,92,71,106,114,69,126,183,87
125,64,113,92,0,78,59,100,75,150,103,109
146,139,52,71,78,0,114,83,129,39,124,114
18,87,89,106,59,114,0,39,11,145,162,66
47,159,86,114,100,83,39,0,132,117,91,70
109,171,67,69,75,129,11,132,0,72,102,137
107,127,79,126,150,39,145,117,72,0,165,72
160,106,138,183,103,124,162,91,102,165,0,125
145,58,87,87,109,114,66,70,137,72,125,0
