0,145,112,112,192,90,57,59,80,100
145,0,99,45,177,116,37,164,120,117
112,99,0,110,23,140,126,97,110,119
112,45,110,0,85,32,142,84,132,41
192,177,23,85,0,98,120,124,109,82
90,116,140,32,98,0,124,106,17,141
57,37,126,142,120,124,0,45,80,63
59,164,97,84,124,106,45,0,52,102
80,120,110,132,109,17,80,52,0,121
100,117,119,41,82,141,63,102,121,0
