0,147,122,170,121,94,115,112,100,114,91,104
147,0,85,39,140,111,70,82,51,96,85,101
122,85,0,80,87,71,111,64,47,57,107,135
170,39,80,0,42,75,43,141,71,166,154,83
121,140,87,42,0,74,34,81,50,35,120,101
94,111,71,75,74,0,7,38,176,156,83,68
115,70,111,43,34,7,0,89,48,63,102,126
112,82,64,141,81,38,89,0,59,120,156,80
100,51,47,71,50,176,48,59,0,110,119,116
114,96,57,166,35,156,63,120,110,0,119,72
91,85,107,154,120,83,102,156,119,119,0,76
104,101,135,83,101,68,126,80,116,72,76,0
