0,119,131,108,180,193,141,148
119,0,102,114,84,105,117,70
131,102,0,61,126,55,147,42
108,114,61,0,69,106,117,60
180,84,126,69,0,64,107,136
193,105,55,106,64,0,143,40
141,117,147,117,107,143,0,66
148,70,42,60,136,40,66,0
