0,72,71,37,157,145,92,67,79,83
72,0,75,96,40,143,65,138,64,49
71,75,0,61,28,163,52,99,53,80
37,96,61,0,114,113,9,110,163,108
157,40,28,114,0,67,116,14,112,40
145,143,163,113,67,0,88,138,96,104
92,65,52,9,116,88,0,143,116,37
67,138,99,110,14,138,143,0,103,108
79,64,53,163,112,96,116,103,0,130
83,49,80,108,40,104,37,108,130,0
