0,68,101,112,123,42,104,140,108,65
68,0,122,87,81,109,163,28,116,140
101,122,0,138,63,138,83,91,95,82
112,87,138,0,91,50,12,105,138,102
123,81,63,91,0,28,80,105,107,88
42,109,138,50,28,0,66,78,87,160
104,163,83,12,80,66,0,48,88,62
140,28,91,105,105,78,48,0,28,81
108,116,95,138,107,87,88,28,0,45
65,140,82,102,88,160,62,81,45,0
