0,127,149,128,61,143,23,50,151
127,0,43,113,72,101,61,111,99
149,43,0,46,135,145,176,117,154
128,113,46,0,142,187,132,98,95
61,72,135,142,0,55,98,163,116
143,101,145,187,55,0,114,145,132
23,61,176,132,98,114,0,146,166
50,111,117,98,163,145,146,0,73
151,99,154,95,116,132,166,73,0
