0,142,90,135,87,137,78,172,111,137,42,132
142,0,107,42,138,149,163,76,57,144,60,157
90,107,0,66,160,125,150,24,108,85,111,81
135,42,66,0,118,59,135,101,76,85,88,114
87,138,160,118,0,41,58,42,149,127,79,75
137,149,125,59,41,0,111,79,124,72,141,100
78,163,150,135,58,111,0,21,41,68,100,101
172,76,24,101,42,79,21,0,125,171,178,103
111,57,108,76,149,124,41,125,0,58,116,112
137,144,85,85,127,72,68,171,58,0,79,73
42,60,111,88,79,141,100,178,116,79,0,44
132,157,81,114,75,100,101,103,112,73,44,0
