0,73,174,133,87,84,102,101
73,0,188,26,120,84,65,108
174,188,0,152,103,120,145,73
133,26,152,0,104,78,53,37
87,120,103,104,0,124,136,113
84,84,120,78,124,0,100,105
102,65,145,53,136,100,0,82
101,108,73,37,113,105,82,0
