0,152,95,52,55,125,34,81,68,176,154
152,0,26,87,77,142,81,101,112,107,130
95,26,0,47,141,22,29,140,109,165,82
52,87,47,0,27,62,159,98,81,33,88
55,77,141,27,0,38,81,132,113,94,48
125,142,22,62,38,0,129,93,66,72,92
34,81,29,159,81,129,0,117,135,50,131
81,101,140,98,132,93,117,0,116,38,135
68,112,109,81,113,66,135,116,0,141,48
176,107,165,33,94,72,50,38,141,0,72
154,130,82,88,48,92,131,135,48,72,0
