0,106,40,175,103,154,80,139,93
106,0,73,102,155,78,37,51,130
40,73,0,96,110,160,97,118,46
175,102,96,0,74,80,156,124,122
103,155,110,74,0,175,116,155,88
154,78,160,80,175,0,105,127,85
80,37,97,156,116,105,0,54,112
139,51,118,124,155,127,54,0,123
93,130,46,122,88,85,112,123,0
