0,124,119,133,115,82,115,121,60,131,73,76
124,0,133,120,40,105,45,99,48,133,103,162
119,133,0,25,130,110,178,90,126,129,146,101
133,120,25,0,106,7,124,96,77,105,78,76
115,40,130,106,0,36,161,80,129,97,106,25
82,105,110,7,36,0,92,124,113,15,116,112
115,45,178,124,161,92,0,177,22,176,156,7
121,99,90,96,80,124,177,0,146,64,119,105
60,48,126,77,129,113,22,146,0,187,124,170
131,133,129,105,97,15,176,64,187,0,117,137
73,103,146,78,106,116,156,119,124,117,0,81
76,162,101,76,25,112,7,105,170,137,81,0
