0,10,76,123,155,22,92,142,105,102,82
10,0,122,174,60,178,53,117,129,90,46
76,122,0,155,125,178,55,93,66,110,58
123,174,155,0,109,57,115,46,134,40,159
155,60,125,109,0,123,152,113,85,132,101
22,178,178,57,123,0,87,32,124,196,147
92,53,55,115,152,87,0,97,146,37,32
142,117,93,46,113,32,97,0,113,81,60
105,129,66,134,85,124,146,113,0,132,103
102,90,110,40,132,196,37,81,132,0,23
82,46,58,159,101,147,32,60,103,23,0
