0,112,59,45,75,82,97,87,129
112,0,113,85,30,130,160,79,101
59,113,0,13,75,124,124,51,135
45,85,13,0,167,143,115,103,90
75,30,75,167,0,80,129,26,89
82,130,124,143,80,0,92,136,143
97,160,124,115,129,92,0,94,104
87,79,51,103,26,136,94,0,96
129,101,135,90,89,143,104,96,0
