0,96,132,136,97,162,57,91,97,109
96,0,125,71,173,115,41,102,88,120
132,125,0,123,69,120,83,151,97,88
136,71,123,0,179,140,52,172,46,119
97,173,69,179,0,72,122,106,126,164
162,115,120,140,72,0,148,63,109,178
57,41,83,52,122,148,0,49,91,123
91,102,151,172,106,63,49,0,132,73
97,88,97,46,126,109,91,132,0,95
109,120,88,119,164,178,123,73,95,0
