0,49,98,117,127,126,65,177,72,80,145,74
49,0,30,153,149,118,152,87,47,66,58,17
98,30,0,93,152,114,113,140,76,151,166,70
117,153,93,0,127,88,105,173,125,120,10,190
127,149,152,127,0,113,157,122,119,106,101,65
126,118,114,88,113,0,34,80,117,58,46,128
65,152,113,105,157,34,0,72,54,60,68,178
177,87,140,173,122,80,72,0,68,58,71,138
72,47,76,125,119,117,54,68,0,66,28,115
80,66,151,120,106,58,60,58,66,0,54,124
145,58,166,10,101,46,68,71,28,54,0,87
74,17,70,190,65,128,178,138,115,124,87,0
