0,105,181,17,104,78,103,155,114,129
105,0,150,156,148,35,86,109,42,70
181,150,0,158,81,94,119,67,143,64
17,156,158,0,187,139,99,92,117,10
104,148,81,187,0,74,93,115,164,37
78,35,94,139,74,0,162,114,101,100
103,86,119,99,93,162,0,150,68,99
155,109,67,92,115,114,150,0,54,105
114,42,143,117,164,101,68,54,0,46
129,70,64,10,37,100,99,105,46,0
