0,156,134,116,149,129,60,110,119,131,182
156,0,28,183,119,67,129,122,139,149,135
134,28,0,60,109,71,106,66,146,138,18
116,183,60,0,109,66,133,135,97,101,51
149,119,109,109,0,79,34,142,62,124,178
129,67,71,66,79,0,129,151,104,82,135
60,129,106,133,34,129,0,67,129,79,162
110,122,66,135,142,151,67,0,129,69,113
119,139,146,97,62,104,129,129,0,109,87
131,149,138,101,124,82,79,69,109,0,98
182,135,18,51,178,135,162,113,87,98,0
