0,168,129,114,84,89,146,62,184
168,0,94,81,124,32,63,19,81
129,94,0,159,113,73,90,93,119
114,81,159,0,92,137,30,158,73
84,124,113,92,0,140,77,65,96
89,32,73,137,140,0,64,119,85
146,63,90,30,77,64,0,59,67
62,19,93,158,65,119,59,0,145
184,81,119,73,96,85,67,145,0
