0,127,54,49,89,111,69,109,59,46,156,90
127,0,163,91,68,156,70,32,111,101,131,15
54,163,0,124,109,69,89,98,121,170,128,125
49,91,124,0,97,119,68,24,168,38,128,151
89,68,109,97,0,95,7,101,90,79,86,90
111,156,69,119,95,0,61,111,128,92,99,123
69,70,89,68,7,61,0,57,124,98,87,103
109,32,98,24,101,111,57,0,33,111,105,47
59,111,121,168,90,128,124,33,0,66,56,150
46,101,170,38,79,92,98,111,66,0,112,32
156,131,128,128,86,99,87,105,56,112,0,93
90,15,125,151,90,123,103,47,150,32,93,0
