0,72,11,100,94,185,102,63,121
72,0,77,40,94,74,156,162,192
11,77,0,124,90,169,159,99,114
100,40,124,0,61,57,45,132,120
94,94,90,61,0,73,187,53,136
185,74,169,57,73,0,153,131,135
102,156,159,45,187,153,0,182,158
63,162,99,132,53,131,182,0,36
121,192,114,120,136,135,158,36,0
