0,52,93,97,105,111,72,30,140
52,0,112,41,108,23,63,101,56
93,112,0,91,133,40,49,84,109
97,41,91,0,51,41,93,114,83
105,108,133,51,0,62,157,16,140
111,23,40,41,62,0,102,35,76
72,63,49,93,157,102,0,96,100
30,101,84,114,16,35,96,0,51
140,56,109,83,140,76,100,51,0
