0,99,89,62,118,111,85,6
99,0,88,126,162,48,64,135
89,88,0,186,31,131,98,88
62,126,186,0,64,151,84,77
118,162,31,64,0,124,81,28
111,48,131,151,124,0,135,114
85,64,98,84,81,135,0,23
6,135,88,77,28,114,23,0
