0,81,84,66,104,186,107,164,152,135,58
81,0,59,101,99,106,126,173,98,87,118
84,59,0,133,108,117,155,191,46,51,116
66,101,133,0,105,108,188,151,175,83,99
104,99,108,105,0,80,14,64,114,170,131
186,106,117,108,80,0,54,146,147,140,55
107,126,155,188,14,54,0,68,138,45,47
164,173,191,151,64,146,68,0,93,52,73
152,98,46,175,114,147,138,93,0,20,107
135,87,51,83,170,140,45,52,20,0,71
58,118,116,99,131,55,47,73,107,71,0
