0,185,73,121,129,138,102,71,67,117
185,0,113,113,172,137,100,160,48,52
73,113,0,134,39,80,99,98,62,30
121,113,134,0,170,76,111,151,103,121
129,172,39,170,0,45,87,57,96,70
138,137,80,76,45,0,26,107,69,136
102,100,99,111,87,26,0,76,139,155
71,160,98,151,57,107,76,0,158,153
67,48,62,103,96,69,139,158,0,102
117,52,30,121,70,136,155,153,102,0
