0,166,167,100,155,110,105,76,19,107
166,0,79,49,165,53,75,106,79,45
167,79,0,94,131,68,104,185,106,90
100,49,94,0,141,47,97,121,118,94
155,165,131,141,0,154,115,125,36,118
110,53,68,47,154,0,55,127,121,102
105,75,104,97,115,55,0,133,69,113
76,106,185,121,125,127,133,0,19,78
19,79,106,118,36,121,69,19,0,49
107,45,90,94,118,102,113,78,49,0
