0,190,60,97,126,172,58,158,119,70,154
190,0,48,83,105,69,105,159,140,88,98
60,48,0,59,76,39,76,87,93,98,118
97,83,59,0,90,122,47,51,132,113,91
126,105,76,90,0,70,167,190,77,44,110
172,69,39,122,70,0,98,112,140,101,24
58,105,76,47,167,98,0,89,152,53,127
158,159,87,51,190,112,89,0,43,99,156
119,140,93,132,77,140,152,43,0,166,84
70,88,98,113,44,101,53,99,166,0,115
154,98,118,91,110,24,127,156,84,115,0
