0,103,119,94,105,112,42,57,131
103,0,59,71,123,123,134,68,126
119,59,0,109,191,94,74,91,104
94,71,109,0,162,28,75,101,133
105,123,191,162,0,102,128,87,107
112,123,94,28,102,0,44,137,105
42,134,74,75,128,44,0,72,125
57,68,91,101,87,137,72,0,103
131,126,104,133,107,105,125,103,0
