0,60,87,86,98,124,64,142,144,151,81,95
60,0,87,46,177,57,81,118,68,130,92,100
87,87,0,132,185,39,86,63,102,25,132,134
86,46,132,0,113,126,184,114,56,120,74,86
98,177,185,113,0,97,61,112,93,103,65,106
124,57,39,126,97,0,92,102,110,13,42,95
64,81,86,184,61,92,0,102,130,55,116,138
142,118,63,114,112,102,102,0,113,109,102,110
144,68,102,56,93,110,130,113,0,101,69,125
151,130,25,120,103,13,55,109,101,0,100,118
81,92,132,74,65,42,116,102,69,100,0,116
95,100,134,86,106,95,138,110,125,118,116,0
