0,126,41,116,115,75,78,145,32
126,0,129,112,42,138,53,107,67
41,129,0,15,168,154,104,95,95
116,112,15,0,93,96,47,38,73
115,42,168,93,0,132,112,141,135
75,138,154,96,132,0,47,138,91
78,53,104,47,112,47,0,58,116
145,107,95,38,141,138,58,0,107
32,67,95,73,135,91,116,107,0
