0,104,173,57,118,120,100,76,112,143,43
104,0,188,30,73,173,79,33,75,121,138
173,188,0,140,180,121,19,28,94,73,126
57,30,140,0,115,141,68,152,71,50,96
118,73,180,115,0,113,118,68,142,120,141
120,173,121,141,113,0,74,60,41,127,103
100,79,19,68,118,74,0,78,47,94,178
76,33,28,152,68,60,78,0,24,74,80
112,75,94,71,142,41,47,24,0,91,141
143,121,73,50,120,127,94,74,91,0,54
43,138,126,96,141,103,178,80,141,54,0
