0,49,113,181,80,121,24,69,37
49,0,70,121,78,59,74,124,68
113,70,0,135,56,153,30,166,146
181,121,135,0,111,55,48,31,81
80,78,56,111,0,167,16,94,137
121,59,153,55,167,0,49,58,43
24,74,30,48,16,49,0,78,164
69,124,166,31,94,58,78,0,142
37,68,146,81,137,43,164,142,0
