0,86,154,109,117,125,94,192,89,139,84,76
86,0,100,59,155,32,125,100,82,148,157,78
154,100,0,30,92,134,66,113,115,147,97,70
109,59,30,0,59,148,141,130,27,122,92,89
117,155,92,59,0,140,42,123,128,177,156,159
125,32,134,148,140,0,99,49,88,52,88,123
94,125,66,141,42,99,0,48,90,115,133,130
192,100,113,130,123,49,48,0,116,171,137,33
89,82,115,27,128,88,90,116,0,125,152,116
139,148,147,122,177,52,115,171,125,0,140,85
84,157,97,92,156,88,133,137,152,140,0,57
76,78,70,89,159,123,130,33,116,85,57,0
