0,21,89,116,94,73,32,113,50,105,104,133
21,0,48,104,111,116,102,25,121,92,37,174
89,48,0,119,80,134,80,87,66,104,100,144
116,104,119,0,93,118,27,105,76,98,111,46
94,111,80,93,0,100,82,85,33,84,108,55
73,116,134,118,100,0,59,108,29,182,78,117
32,102,80,27,82,59,0,88,91,137,60,161
113,25,87,105,85,108,88,0,87,130,97,156
50,121,66,76,33,29,91,87,0,133,101,52
105,92,104,98,84,182,137,130,133,0,97,131
104,37,100,111,108,78,60,97,101,97,0,109
133,174,144,46,55,117,161,156,52,131,109,0
