0,81,61,144,110,87,132,113,113,143,75,107
81,0,90,121,70,111,96,14,130,85,118,67
61,90,0,177,33,143,98,102,159,101,62,120
144,121,177,0,46,143,99,73,108,105,119,112
110,70,33,46,0,121,98,149,109,95,80,147
87,111,143,143,121,0,60,82,65,171,56,41
132,96,98,99,98,60,0,138,96,153,71,151
113,14,102,73,149,82,138,0,31,78,43,117
113,130,159,108,109,65,96,31,0,117,70,71
143,85,101,105,95,171,153,78,117,0,56,70
75,118,62,119,80,56,71,43,70,56,0,53
107,67,120,112,147,41,151,117,71,70,53,0
