0,130,144,109,92,35,87,163
130,0,135,87,163,73,78,110
144,135,0,135,69,125,84,136
109,87,135,0,70,97,78,145
92,163,69,70,0,65,35,81
35,73,125,97,65,0,35,70
87,78,84,78,35,35,0,131
163,110,136,145,81,70,131,0
