0,29,180,195,89,101,103,112,79,156,17
29,0,102,160,72,147,43,61,22,138,61
180,102,0,137,175,113,45,124,78,87,45
195,160,137,0,60,85,83,123,104,133,162
89,72,175,60,0,105,86,106,115,51,95
101,147,113,85,105,0,83,50,25,81,14
103,43,45,83,86,83,0,157,108,43,130
112,61,124,123,106,50,157,0,103,25,70
79,22,78,104,115,25,108,103,0,39,114
156,138,87,133,51,81,43,25,39,0,44
17,61,45,162,95,14,130,70,114,44,0
