0,136,153,140,81,99,87,105,113
136,0,127,124,45,174,175,140,85
153,127,0,103,149,86,175,81,47
140,124,103,0,154,138,117,64,66
81,45,149,154,0,60,59,127,44
99,174,86,138,60,0,105,159,62
87,175,175,117,59,105,0,17,150
105,140,81,64,127,159,17,0,132
113,85,47,66,44,62,150,132,0
