0,146,79,122,144,38,150,8,82,96,114,118
146,0,75,63,47,130,80,123,56,124,105,151
79,75,0,70,101,153,98,114,125,58,106,148
122,63,70,0,130,100,71,136,58,128,98,96
144,47,101,130,0,97,61,60,77,44,74,94
38,130,153,100,97,0,94,117,68,105,81,119
150,80,98,71,61,94,0,140,59,117,72,102
8,123,114,136,60,117,140,0,102,153,93,153
82,56,125,58,77,68,59,102,0,10,65,124
96,124,58,128,44,105,117,153,10,0,8,110
114,105,106,98,74,81,72,93,65,8,0,82
118,151,148,96,94,119,102,153,124,110,82,0
