0,95,47,53,103,175,67,99,142
95,0,133,118,117,54,92,179,117
47,133,0,61,67,63,72,78,97
53,118,61,0,17,151,116,34,134
103,117,67,17,0,68,152,108,153
175,54,63,151,68,0,45,142,141
67,92,72,116,152,45,0,114,37
99,179,78,34,108,142,114,0,90
142,117,97,134,153,141,37,90,0
