0,135,171,57,71,23,46,106,111,60,78
135,0,109,105,110,135,115,177,110,66,44
171,109,0,60,86,61,54,136,138,189,97
57,105,60,0,163,101,77,81,117,118,25
71,110,86,163,0,135,16,108,112,155,56
23,135,61,101,135,0,120,90,104,108,77
46,115,54,77,16,120,0,59,133,80,73
106,177,136,81,108,90,59,0,81,115,119
111,110,138,117,112,104,133,81,0,138,76
60,66,189,118,155,108,80,115,138,0,92
78,44,97,25,56,77,73,119,76,92,0
