0,94,10,76,127,112,127,92,115,91,145
94,0,100,37,108,48,91,70,66,140,48
10,100,0,53,170,119,166,53,107,40,127
76,37,53,0,117,34,124,122,50,89,87
127,108,170,117,0,91,26,138,14,113,107
112,48,119,34,91,0,141,141,134,108,151
127,91,166,124,26,141,0,32,71,32,76
92,70,53,122,138,141,32,0,106,178,111
115,66,107,50,14,134,71,106,0,101,134
91,140,40,89,113,108,32,178,101,0,43
145,48,127,87,107,151,76,111,134,43,0
