0,149,96,87,145,131,135,78,147,173
149,0,83,42,51,25,118,118,90,64
96,83,0,126,72,140,48,187,94,37
87,42,126,0,116,182,94,171,37,20
145,51,72,116,0,119,67,120,173,64
131,25,140,182,119,0,129,61,160,113
135,118,48,94,67,129,0,161,83,140
78,118,187,171,120,61,161,0,76,56
147,90,94,37,173,160,83,76,0,87
173,64,37,20,64,113,140,56,87,0
