0,97,138,84,162,160,19,104
97,0,126,64,39,50,57,36
138,126,0,114,60,101,146,126
84,64,114,0,128,110,90,145
162,39,60,128,0,28,53,106
160,50,101,110,28,0,122,95
19,57,146,90,53,122,0,85
104,36,126,145,106,95,85,0
