0,124,151,126,99,149,116,124
124,0,124,140,161,100,37,98
151,124,0,115,103,90,94,116
126,140,115,0,121,76,105,115
99,161,103,121,0,163,144,108
149,100,90,76,163,0,83,122
116,37,94,105,144,83,0,184
124,98,116,115,108,122,184,0
