0,122,34,173,90,119,93,95,62,75
122,0,10,94,85,60,59,94,83,131
34,10,0,168,128,98,116,105,83,109
173,94,168,0,116,84,129,120,142,133
90,85,128,116,0,59,105,117,146,150
119,60,98,84,59,0,76,38,83,177
93,59,116,129,105,76,0,124,53,86
95,94,105,120,117,38,124,0,28,158
62,83,83,142,146,83,53,28,0,161
75,131,109,133,150,177,86,158,161,0
