0,85,60,92,100,95,45,75
85,0,58,113,104,71,98,136
60,58,0,109,147,64,124,109
92,113,109,0,153,84,83,59
100,104,147,153,0,144,44,79
95,71,64,84,144,0,116,100
45,98,124,83,44,116,0,158
75,136,109,59,79,100,158,0
