0,119,126,50,137,136,97,44,68,76,71
119,0,94,184,121,121,84,41,95,167,43
126,94,0,37,114,83,65,141,117,83,115
50,184,37,0,74,52,146,135,65,62,77
137,121,114,74,0,46,193,122,90,105,36
136,121,83,52,46,0,81,112,156,114,34
97,84,65,146,193,81,0,30,113,97,117
44,41,141,135,122,112,30,0,53,108,147
68,95,117,65,90,156,113,53,0,22,60
76,167,83,62,105,114,97,108,22,0,77
71,43,115,77,36,34,117,147,60,77,0
