0,74,92,118,162,140,107,71
74,0,66,65,79,121,86,106
92,66,0,68,96,132,55,68
118,65,68,0,172,122,47,145
162,79,96,172,0,125,49,131
140,121,132,122,125,0,92,154
107,86,55,47,49,92,0,59
71,106,68,145,131,154,59,0
