0,114,181,120,61,167,68,84,67
114,0,115,87,14,38,157,104,161
181,115,0,145,79,119,75,86,164
120,87,145,0,131,112,28,172,68
61,14,79,131,0,80,96,155,79
167,38,119,112,80,0,139,155,30
68,157,75,28,96,139,0,132,179
84,104,86,172,155,155,132,0,54
67,161,164,68,79,30,179,54,0
