0,129,140,89,98,24,29,89,119,92,22,96
129,0,84,89,90,109,119,117,68,69,138,67
140,84,0,15,37,62,121,158,131,94,98,48
89,89,15,0,27,66,109,102,119,115,97,73
98,90,37,27,0,165,128,89,159,26,134,43
24,109,62,66,165,0,65,124,85,56,133,87
29,119,121,109,128,65,0,41,92,113,89,29
89,117,158,102,89,124,41,0,182,190,109,95
119,68,131,119,159,85,92,182,0,102,33,155
92,69,94,115,26,56,113,190,102,0,120,138
22,138,98,97,134,133,89,109,33,120,0,34
96,67,48,73,43,87,29,95,155,138,34,0
