0,46,100,120,117,84,77,130
46,0,14,98,114,121,125,23
100,14,0,104,145,98,103,8
120,98,104,0,94,98,128,120
117,114,145,94,0,145,102,54
84,121,98,98,145,0,160,108
77,125,103,128,102,160,0,68
130,23,8,120,54,108,68,0
