0,84,119,33,17,102,102,65,114,79,166,135
84,0,144,91,162,43,125,88,75,80,127,101
119,144,0,112,36,141,100,127,108,14,76,48
33,91,112,0,113,38,113,77,152,82,70,71
17,162,36,113,0,141,62,131,43,58,101,176
102,43,141,38,141,0,120,85,127,104,64,135
102,125,100,113,62,120,0,118,99,164,157,116
65,88,127,77,131,85,118,0,87,99,62,24
114,75,108,152,43,127,99,87,0,94,89,44
79,80,14,82,58,104,164,99,94,0,55,109
166,127,76,70,101,64,157,62,89,55,0,107
135,101,48,71,176,135,116,24,44,109,107,0
