0,31,57,149,95,83,86,92
31,0,78,58,155,124,86,86
57,78,0,73,95,88,86,109
149,58,73,0,148,81,36,45
95,155,95,148,0,137,63,131
83,124,88,81,137,0,122,98
86,86,86,36,63,122,0,106
92,86,109,45,131,98,106,0
