0,92,115,130,81,43,54,52,163,77,170
92,0,119,76,70,187,149,110,112,63,185
115,119,0,142,161,71,62,114,79,160,98
130,76,142,0,138,79,144,125,173,88,75
81,70,161,138,0,104,93,33,96,46,36
43,187,71,79,104,0,100,120,109,149,142
54,149,62,144,93,100,0,61,81,122,92
52,110,114,125,33,120,61,0,51,18,31
163,112,79,173,96,109,81,51,0,97,106
77,63,160,88,46,149,122,18,97,0,133
170,185,98,75,36,142,92,31,106,133,0
