0,151,108,81,95,142,61,48,100,98
151,0,109,93,21,118,59,110,97,64
108,109,0,164,42,125,91,91,110,122
81,93,164,0,87,178,52,92,113,102
95,21,42,87,0,60,76,94,113,95
142,118,125,178,60,0,88,123,37,110
61,59,91,52,76,88,0,84,170,136
48,110,91,92,94,123,84,0,110,106
100,97,110,113,113,37,170,110,0,117
98,64,122,102,95,110,136,106,117,0
