0,86,167,105,152,21,119,150,22
86,0,111,187,82,23,26,146,106
167,111,0,97,58,100,52,117,52
105,187,97,0,90,103,111,67,130
152,82,58,90,0,162,41,47,97
21,23,100,103,162,0,136,181,32
119,26,52,111,41,136,0,75,70
150,146,117,67,47,181,75,0,22
22,106,52,130,97,32,70,22,0
