0,79,6,19,76,84,60,94,148
79,0,167,120,128,37,95,149,145
6,167,0,2,102,71,87,67,62
19,120,2,0,141,50,168,132,92
76,128,102,141,0,123,131,63,89
84,37,71,50,123,0,122,60,107
60,95,87,168,131,122,0,126,164
94,149,67,132,63,60,126,0,87
148,145,62,92,89,107,164,87,0
