0,107,130,129,55,176,100,112,131,54
107,0,97,130,126,120,142,117,73,19
130,97,0,126,65,44,128,41,106,130
129,130,126,0,89,70,86,103,142,166
55,126,65,89,0,177,80,53,130,88
176,120,44,70,177,0,105,59,166,84
100,142,128,86,80,105,0,119,31,86
112,117,41,103,53,59,119,0,113,119
131,73,106,142,130,166,31,113,0,98
54,19,130,166,88,84,86,119,98,0
