0,106,58,68,62,114,78,126,98
106,0,92,171,131,35,69,37,70
58,92,0,55,84,153,123,78,125
68,171,55,0,81,144,100,127,96
62,131,84,81,0,93,84,37,107
114,35,153,144,93,0,169,76,174
78,69,123,100,84,169,0,106,123
126,37,78,127,37,76,106,0,30
98,70,125,96,107,174,123,30,0
