0,133,94,135,27,145,134,89,155,32,7
133,0,89,73,105,84,86,108,98,24,94
94,89,0,60,40,126,100,135,78,36,81
135,73,60,0,119,26,159,100,32,109,98
27,105,40,119,0,176,110,137,83,75,80
145,84,126,26,176,0,116,56,60,13,15
134,86,100,159,110,116,0,152,46,10,127
89,108,135,100,137,56,152,0,49,60,108
155,98,78,32,83,60,46,49,0,53,77
32,24,36,109,75,13,10,60,53,0,27
7,94,81,98,80,15,127,108,77,27,0
