0,183,72,134,136,142,17,60,82,130,45
183,0,85,124,65,45,150,166,63,97,149
72,85,0,50,61,58,122,54,110,109,80
134,124,50,0,45,120,47,116,167,132,161
136,65,61,45,0,84,38,61,77,88,75
142,45,58,120,84,0,37,75,118,167,129
17,150,122,47,38,37,0,103,70,63,86
60,166,54,116,61,75,103,0,63,127,92
82,63,110,167,77,118,70,63,0,50,113
130,97,109,132,88,167,63,127,50,0,124
45,149,80,161,75,129,86,92,113,124,0
