0,61,71,119,126,149,33,63,148
61,0,72,88,133,88,94,160,69
71,72,0,100,192,107,101,11,56
119,88,100,0,47,32,88,22,135
126,133,192,47,0,50,126,44,120
149,88,107,32,50,0,114,48,38
33,94,101,88,126,114,0,95,79
63,160,11,22,44,48,95,0,112
148,69,56,135,120,38,79,112,0
