0,80,75,134,60,148,121,79
80,0,29,86,107,75,62,69
75,29,0,74,189,81,168,111
134,86,74,0,74,94,131,82
60,107,189,74,0,147,29,29
148,75,81,94,147,0,37,95
121,62,168,131,29,37,0,145
79,69,111,82,29,95,145,0
