0,121,157,63,134,60,49,166,80,78,103,146
121,0,137,119,105,96,40,47,68,26,130,89
157,137,0,45,106,79,80,89,58,107,58,25
63,119,45,0,72,108,69,97,162,88,51,178
134,105,106,72,0,95,177,67,121,137,39,170
60,96,79,108,95,0,102,143,102,123,148,150
49,40,80,69,177,102,0,94,82,120,147,88
166,47,89,97,67,143,94,0,103,94,83,106
80,68,58,162,121,102,82,103,0,99,103,40
78,26,107,88,137,123,120,94,99,0,186,95
103,130,58,51,39,148,147,83,103,186,0,102
146,89,25,178,170,150,88,106,40,95,102,0
