0,111,90,138,31,83,37,96,133,95
111,0,113,60,114,98,92,147,42,11
90,113,0,105,87,44,119,87,73,120
138,60,105,0,141,71,105,129,81,66
31,114,87,141,0,152,88,139,165,136
83,98,44,71,152,0,150,159,178,62
37,92,119,105,88,150,0,171,122,78
96,147,87,129,139,159,171,0,55,189
133,42,73,81,165,178,122,55,0,101
95,11,120,66,136,62,78,189,101,0
