0,129,100,135,130,69,112,23,120
129,0,81,73,134,147,140,110,124
100,81,0,84,141,153,82,179,86
135,73,84,0,118,78,118,113,79
130,134,141,118,0,183,105,155,126
69,147,153,78,183,0,74,84,143
112,140,82,118,105,74,0,92,133
23,110,179,113,155,84,92,0,40
120,124,86,79,126,143,133,40,0
