0,99,190,127,181,161,179,16,125,106,139,105
99,0,41,102,74,184,45,185,74,113,131,158
190,41,0,87,118,146,74,100,115,171,151,29
127,102,87,0,110,137,85,58,142,58,83,187
181,74,118,110,0,122,127,80,97,63,47,144
161,184,146,137,122,0,154,121,68,85,91,174
179,45,74,85,127,154,0,81,78,132,143,181
16,185,100,58,80,121,81,0,82,80,102,64
125,74,115,142,97,68,78,82,0,84,131,78
106,113,171,58,63,85,132,80,84,0,99,59
139,131,151,83,47,91,143,102,131,99,0,115
105,158,29,187,144,174,181,64,78,59,115,0
