0,118,107,125,124,160,134,115,77
118,0,64,138,134,104,135,41,108
107,64,0,72,118,108,86,86,78
125,138,72,0,71,30,67,22,63
124,134,118,71,0,28,12,55,91
160,104,108,30,28,0,73,53,160
134,135,86,67,12,73,0,46,36
115,41,86,22,55,53,46,0,85
77,108,78,63,91,160,36,85,0
