0,111,175,133,90,61,99,85,58,111,72,48
111,0,116,105,62,148,153,124,91,70,43,129
175,116,0,102,71,66,114,161,52,64,93,55
133,105,102,0,111,121,21,123,51,173,84,90
90,62,71,111,0,149,65,39,77,158,51,138
61,148,66,121,149,0,114,71,42,115,83,126
99,153,114,21,65,114,0,173,96,123,126,176
85,124,161,123,39,71,173,0,32,79,126,90
58,91,52,51,77,42,96,32,0,128,108,78
111,70,64,173,158,115,123,79,128,0,154,25
72,43,93,84,51,83,126,126,108,154,0,17
48,129,55,90,138,126,176,90,78,25,17,0
