0,106,116,163,106,88,78,100,58,59
106,0,139,84,175,106,98,82,157,126
116,139,0,73,157,107,132,31,72,28
163,84,73,0,132,176,120,152,113,133
106,175,157,132,0,122,45,131,116,118
88,106,107,176,122,0,100,82,119,44
78,98,132,120,45,100,0,122,148,106
100,82,31,152,131,82,122,0,63,96
58,157,72,113,116,119,148,63,0,148
59,126,28,133,118,44,106,96,148,0
