0,121,135,88,87,88,95,114,79,99,71
121,0,41,130,73,155,139,108,91,56,42
135,41,0,80,129,91,147,43,87,110,80
88,130,80,0,83,52,155,152,150,93,174
87,73,129,83,0,94,180,10,158,87,19
88,155,91,52,94,0,99,173,66,91,69
95,139,147,155,180,99,0,121,94,70,123
114,108,43,152,10,173,121,0,82,127,93
79,91,87,150,158,66,94,82,0,131,141
99,56,110,93,87,91,70,127,131,0,97
71,42,80,174,19,69,123,93,141,97,0
