0,184,59,111,63,24,93,56,88
184,0,93,123,95,37,63,149,79
59,93,0,116,50,83,76,101,175
111,123,116,0,161,129,89,75,90
63,95,50,161,0,89,180,101,140
24,37,83,129,89,0,93,128,59
93,63,76,89,180,93,0,117,89
56,149,101,75,101,128,117,0,66
88,79,175,90,140,59,89,66,0
