0,112,97,101,88,112,148,45
112,0,120,138,101,137,44,46
97,120,0,128,81,46,25,85
101,138,128,0,104,149,121,111
88,101,81,104,0,57,69,45
112,137,46,149,57,0,159,118
148,44,25,121,69,159,0,39
45,46,85,111,45,118,39,0
