0,129,81,21,40,127,145,45
129,0,98,177,158,170,172,131
81,98,0,108,57,53,97,129
21,177,108,0,62,115,67,79
40,158,57,62,0,129,51,81
127,170,53,115,129,0,77,45
145,172,97,67,51,77,0,66
45,131,129,79,81,45,66,0
