0,97,56,70,67,48,87,173,113,58,142
97,0,67,116,84,102,178,51,104,68,99
56,67,0,29,122,58,96,89,98,57,7
70,116,29,0,123,71,111,117,78,51,101
67,84,122,123,0,89,148,95,65,127,121
48,102,58,71,89,0,71,13,175,131,51
87,178,96,111,148,71,0,129,91,111,89
173,51,89,117,95,13,129,0,112,33,106
113,104,98,78,65,175,91,112,0,107,176
58,68,57,51,127,131,111,33,107,0,134
142,99,7,101,121,51,89,106,176,134,0
