0,139,148,57,32,29,120,124
139,0,5,45,117,99,183,108
148,5,0,139,103,140,77,68
57,45,139,0,84,84,56,156
32,117,103,84,0,107,88,113
29,99,140,84,107,0,129,60
120,183,77,56,88,129,0,121
124,108,68,156,113,60,121,0
