0,61,123,115,121,171,63,81,53,99,103,44
61,0,133,172,76,87,46,167,90,98,105,91
123,133,0,120,194,115,140,49,160,89,134,67
115,172,120,0,36,60,89,55,88,107,169,6
121,76,194,36,0,49,96,25,101,108,79,146
171,87,115,60,49,0,143,105,147,68,123,183
63,46,140,89,96,143,0,19,128,53,93,140
81,167,49,55,25,105,19,0,34,172,68,104
53,90,160,88,101,147,128,34,0,58,88,42
99,98,89,107,108,68,53,172,58,0,24,131
103,105,134,169,79,123,93,68,88,24,0,153
44,91,67,6,146,183,140,104,42,131,153,0
