0,116,97,12,63,40,106,84,103,116,124
116,0,58,110,141,68,75,51,6,167,94
97,58,0,156,130,47,72,87,109,164,119
12,110,156,0,161,118,47,134,109,56,81
63,141,130,161,0,139,76,65,114,28,86
40,68,47,118,139,0,178,109,85,146,59
106,75,72,47,76,178,0,136,47,115,26
84,51,87,134,65,109,136,0,105,73,93
103,6,109,109,114,85,47,105,0,103,163
116,167,164,56,28,146,115,73,103,0,105
124,94,119,81,86,59,26,93,163,105,0
