0,125,113,56,68,95,134,70,55,184
125,0,36,17,86,113,108,66,68,47
113,36,0,124,72,110,49,139,111,59
56,17,124,0,105,73,108,67,90,90
68,86,72,105,0,153,104,60,92,23
95,113,110,73,153,0,99,90,37,153
134,108,49,108,104,99,0,82,127,67
70,66,139,67,60,90,82,0,74,93
55,68,111,90,92,37,127,74,0,67
184,47,59,90,23,153,67,93,67,0
