0,101,50,131,156,108,163,92,98
101,0,114,181,87,132,110,163,80
50,114,0,120,147,59,46,13,59
131,181,120,0,84,45,125,83,54
156,87,147,84,0,88,132,110,106
108,132,59,45,88,0,93,79,57
163,110,46,125,132,93,0,81,93
92,163,13,83,110,79,81,0,167
98,80,59,54,106,57,93,167,0
