0,137,121,97,60,28,140,20,21
137,0,88,128,114,76,127,127,60
121,88,0,42,90,131,101,75,133
97,128,42,0,93,163,42,48,93
60,114,90,93,0,154,102,5,37
28,76,131,163,154,0,80,142,140
140,127,101,42,102,80,0,36,121
20,127,75,48,5,142,36,0,58
21,60,133,93,37,140,121,58,0
