0,98,135,105,101,112,130,112
98,0,82,53,119,176,85,99
135,82,0,80,81,63,34,24
105,53,80,0,92,96,62,109
101,119,81,92,0,64,102,27
112,176,63,96,64,0,91,159
130,85,34,62,102,91,0,145
112,99,24,109,27,159,145,0
