0,144,152,143,112,108,53,179,39,61,144,114
144,0,67,130,145,80,44,122,118,92,112,174
152,67,0,53,83,132,96,158,118,117,140,99
143,130,53,0,105,66,56,97,155,152,94,78
112,145,83,105,0,43,79,120,46,166,79,53
108,80,132,66,43,0,107,37,64,93,161,144
53,44,96,56,79,107,0,104,117,60,122,156
179,122,158,97,120,37,104,0,88,42,165,73
39,118,118,155,46,64,117,88,0,128,31,63
61,92,117,152,166,93,60,42,128,0,72,142
144,112,140,94,79,161,122,165,31,72,0,97
114,174,99,78,53,144,156,73,63,142,97,0
