0,90,128,89,152,134,51,49,121,104
90,0,61,146,105,130,73,123,25,50
128,61,0,170,67,104,62,95,97,183
89,146,170,0,120,188,96,144,125,158
152,105,67,120,0,38,142,89,138,68
134,130,104,188,38,0,67,127,59,126
51,73,62,96,142,67,0,104,63,166
49,123,95,144,89,127,104,0,35,101
121,25,97,125,138,59,63,35,0,102
104,50,183,158,68,126,166,101,102,0
