0,176,72,157,98,184,139,149,88,196,112,72
176,0,71,185,80,111,114,41,91,86,179,112
72,71,0,88,136,63,140,106,59,167,139,86
157,185,88,0,95,67,97,87,127,141,119,145
98,80,136,95,0,104,147,144,64,50,41,115
184,111,63,67,104,0,118,168,93,118,78,137
139,114,140,97,147,118,0,109,108,120,116,88
149,41,106,87,144,168,109,0,146,134,58,100
88,91,59,127,64,93,108,146,0,86,115,51
196,86,167,141,50,118,120,134,86,0,148,98
112,179,139,119,41,78,116,58,115,148,0,84
72,112,86,145,115,137,88,100,51,98,84,0
