0,76,152,107,78,147,46,151,99,50,138,94
76,0,83,111,98,104,105,115,82,103,133,137
152,83,0,171,52,72,126,181,108,146,111,103
107,111,171,0,76,33,124,39,92,78,181,63
78,98,52,76,0,54,132,26,77,35,37,92
147,104,72,33,54,0,145,164,163,154,61,50
46,105,126,124,132,145,0,46,118,121,70,50
151,115,181,39,26,164,46,0,84,82,78,67
99,82,108,92,77,163,118,84,0,160,72,98
50,103,146,78,35,154,121,82,160,0,59,63
138,133,111,181,37,61,70,78,72,59,0,174
94,137,103,63,92,50,50,67,98,63,174,0
