0,95,184,135,62,70,127,110,72,60,12
95,0,153,57,84,171,69,168,108,64,79
184,153,0,56,148,105,99,72,58,73,124
135,57,56,0,62,83,75,134,73,32,107
62,84,148,62,0,154,147,118,98,106,44
70,171,105,83,154,0,61,108,60,96,106
127,69,99,75,147,61,0,144,111,123,131
110,168,72,134,118,108,144,0,100,182,107
72,108,58,73,98,60,111,100,0,74,167
60,64,73,32,106,96,123,182,74,0,81
12,79,124,107,44,106,131,107,167,81,0
