0,101,128,98,159,108,54,113,185,62,115
101,0,131,128,159,96,118,7,89,102,83
128,131,0,105,109,73,169,189,109,120,105
98,128,105,0,151,129,87,127,162,139,100
159,159,109,151,0,144,51,8,116,56,157
108,96,73,129,144,0,149,74,89,76,166
54,118,169,87,51,149,0,7,84,57,69
113,7,189,127,8,74,7,0,170,75,119
185,89,109,162,116,89,84,170,0,123,22
62,102,120,139,56,76,57,75,123,0,71
115,83,105,100,157,166,69,119,22,71,0
