0,56,186,76,72,133,143,87,158,99
56,0,116,176,91,171,42,16,173,27
186,116,0,95,68,103,74,77,99,68
76,176,95,0,37,116,78,164,34,56
72,91,68,37,0,69,125,111,95,56
133,171,103,116,69,0,101,106,49,167
143,42,74,78,125,101,0,89,108,35
87,16,77,164,111,106,89,0,82,167
158,173,99,34,95,49,108,82,0,97
99,27,68,56,56,167,35,167,97,0
