0,120,80,86,93,97,57,64,145,68,98
120,0,119,138,110,63,81,128,27,79,128
80,119,0,84,56,89,88,24,139,26,108
86,138,84,0,132,36,124,47,57,85,51
93,110,56,132,0,113,76,98,148,127,39
97,63,89,36,113,0,122,157,67,47,91
57,81,88,124,76,122,0,87,163,130,44
64,128,24,47,98,157,87,0,122,54,131
145,27,139,57,148,67,163,122,0,116,71
68,79,26,85,127,47,130,54,116,0,98
98,128,108,51,39,91,44,131,71,98,0
