0,136,133,13,179,57,92,168,119,134,92
136,0,141,30,171,94,56,122,121,17,79
133,141,0,93,83,90,136,85,95,84,115
13,30,93,0,32,76,136,128,152,153,111
179,171,83,32,0,70,47,59,153,76,89
57,94,90,76,70,0,133,97,154,88,133
92,56,136,136,47,133,0,76,50,153,169
168,122,85,128,59,97,76,0,30,159,110
119,121,95,152,153,154,50,30,0,133,67
134,17,84,153,76,88,153,159,133,0,153
92,79,115,111,89,133,169,110,67,153,0
