0,52,136,132,48,117,154,86,159,139
52,0,106,66,53,100,134,140,115,136
136,106,0,18,97,96,99,42,82,118
132,66,18,0,66,99,62,88,103,69
48,53,97,66,0,88,84,142,26,60
117,100,96,99,88,0,102,74,85,31
154,134,99,62,84,102,0,25,115,78
86,140,42,88,142,74,25,0,168,133
159,115,82,103,26,85,115,168,0,100
139,136,118,69,60,31,78,133,100,0
