0,108,102,91,173,119,25,108,142
108,0,45,86,58,64,116,174,85
102,45,0,127,93,152,100,95,167
91,86,127,0,94,143,129,146,110
173,58,93,94,0,35,89,67,186
119,64,152,143,35,0,53,117,166
25,116,100,129,89,53,0,57,83
108,174,95,146,67,117,57,0,80
142,85,167,110,186,166,83,80,0
