0,74,187,36,97,82,155,87,49
74,0,105,51,118,51,116,189,37
187,105,0,60,102,174,95,29,79
36,51,60,0,20,154,77,153,117
97,118,102,20,0,55,154,51,165
82,51,174,154,55,0,116,89,67
155,116,95,77,154,116,0,176,18
87,189,29,153,51,89,176,0,122
49,37,79,117,165,67,18,122,0
