0,55,155,151,20,69,121,45,106,53,90
55,0,120,121,74,162,89,117,156,53,65
155,120,0,146,46,152,169,109,44,175,72
151,121,146,0,48,172,161,112,36,145,23
20,74,46,48,0,120,22,132,124,137,93
69,162,152,172,120,0,67,108,122,111,115
121,89,169,161,22,67,0,186,107,147,134
45,117,109,112,132,108,186,0,78,168,101
106,156,44,36,124,122,107,78,0,115,101
53,53,175,145,137,111,147,168,115,0,161
90,65,72,23,93,115,134,101,101,161,0
