0,108,92,61,45,83,140,75
108,0,25,79,55,125,105,63
92,25,0,54,85,17,89,83
61,79,54,0,134,78,89,64
45,55,85,134,0,78,99,126
83,125,17,78,78,0,61,78
140,105,89,89,99,61,0,176
75,63,83,64,126,78,176,0
