0,118,67,93,112,28,78,82
118,0,62,137,104,77,141,111
67,62,0,80,165,57,35,162
93,137,80,0,89,108,71,104
112,104,165,89,0,118,51,105
28,77,57,108,118,0,90,43
78,141,35,71,51,90,0,111
82,111,162,104,105,43,111,0
