0,98,159,89,58,103,161,90,88,37,109,142
98,0,126,147,130,129,56,113,52,54,101,94
159,126,0,58,132,72,102,89,51,101,48,100
89,147,58,0,49,64,124,149,173,45,135,130
58,130,132,49,0,140,128,61,16,46,86,111
103,129,72,64,140,0,30,122,92,83,141,42
161,56,102,124,128,30,0,108,47,132,152,54
90,113,89,149,61,122,108,0,85,86,155,113
88,52,51,173,16,92,47,85,0,86,141,63
37,54,101,45,46,83,132,86,86,0,116,93
109,101,48,135,86,141,152,155,141,116,0,65
142,94,100,130,111,42,54,113,63,93,65,0
