0,30,93,115,83,103,81,58,173
30,0,21,37,74,90,87,73,74
93,21,0,126,49,170,146,171,155
115,37,126,0,42,173,24,57,117
83,74,49,42,0,61,55,100,99
103,90,170,173,61,0,61,111,31
81,87,146,24,55,61,0,95,88
58,73,171,57,100,111,95,0,70
173,74,155,117,99,31,88,70,0
