0,152,145,146,173,31,54,33
152,0,73,100,57,121,145,124
145,73,0,97,131,111,84,107
146,100,97,0,135,82,111,70
173,57,131,135,0,103,71,123
31,121,111,82,103,0,76,131
54,145,84,111,71,76,0,66
33,124,107,70,123,131,66,0
