0,73,100,129,128,73,81,88
73,0,112,119,139,65,52,85
100,112,0,144,142,92,28,37
129,119,144,0,75,118,92,142
128,139,142,75,0,65,46,65
73,65,92,118,65,0,53,107
81,52,28,92,46,53,0,74
88,85,37,142,65,107,74,0
