0,74,81,91,74,94,178,57,75,92,117,94
74,0,142,7,89,150,160,70,132,46,73,115
81,142,0,157,67,47,97,133,87,77,36,108
91,7,157,0,77,86,35,23,142,130,50,128
74,89,67,77,0,46,135,100,13,128,50,177
94,150,47,86,46,0,54,114,166,113,99,31
178,160,97,35,135,54,0,73,117,114,140,116
57,70,133,23,100,114,73,0,92,158,122,69
75,132,87,142,13,166,117,92,0,108,101,156
92,46,77,130,128,113,114,158,108,0,152,105
117,73,36,50,50,99,140,122,101,152,0,169
94,115,108,128,177,31,116,69,156,105,169,0
