0,88,181,79,100,105,91,35,66,79
88,0,104,100,80,118,105,60,34,146
181,104,0,47,140,141,53,61,77,22
79,100,47,0,180,142,101,41,108,32
100,80,140,180,0,178,141,147,56,36
105,118,141,142,178,0,161,55,106,61
91,105,53,101,141,161,0,27,42,167
35,60,61,41,147,55,27,0,35,118
66,34,77,108,56,106,42,35,0,71
79,146,22,32,36,61,167,118,71,0
