0,124,109,102,132,78,107,121
124,0,123,118,149,112,146,119
109,123,0,32,9,24,157,127
102,118,32,0,34,161,27,85
132,149,9,34,0,116,146,92
78,112,24,161,116,0,139,150
107,146,157,27,146,139,0,108
121,119,127,85,92,150,108,0
