0,54,30,86,121,74,103,46,57,17,45,77
54,0,148,91,132,93,65,117,147,99,112,166
30,148,0,122,100,133,65,43,156,124,91,120
86,91,122,0,112,125,112,106,77,27,57,189
121,132,100,112,0,51,131,50,47,87,110,106
74,93,133,125,51,0,39,73,82,83,112,96
103,65,65,112,131,39,0,109,159,146,71,105
46,117,43,106,50,73,109,0,132,177,125,47
57,147,156,77,47,82,159,132,0,129,115,92
17,99,124,27,87,83,146,177,129,0,113,30
45,112,91,57,110,112,71,125,115,113,0,103
77,166,120,189,106,96,105,47,92,30,103,0
