0,17,170,117,120,61,141,80,173,78
17,0,51,125,95,121,129,106,59,123
170,51,0,117,95,100,56,64,73,46
117,125,117,0,81,64,66,173,107,75
120,95,95,81,0,101,99,154,135,147
61,121,100,64,101,0,172,15,95,107
141,129,56,66,99,172,0,181,134,66
80,106,64,173,154,15,181,0,118,91
173,59,73,107,135,95,134,118,0,145
78,123,46,75,147,107,66,91,145,0
