0,98,158,78,87,122,141,37,110,40,120
98,0,149,63,131,97,15,15,42,56,84
158,149,0,169,121,92,72,120,111,29,16
78,63,169,0,57,156,9,148,42,143,93
87,131,121,57,0,78,72,106,135,34,87
122,97,92,156,78,0,169,60,172,95,94
141,15,72,9,72,169,0,158,107,84,103
37,15,120,148,106,60,158,0,152,73,133
110,42,111,42,135,172,107,152,0,80,145
40,56,29,143,34,95,84,73,80,0,23
120,84,16,93,87,94,103,133,145,23,0
