0,69,76,143,104,39,165,64,114,47
69,0,5,188,113,108,69,164,90,173
76,5,0,101,38,50,133,45,60,112
143,188,101,0,150,40,76,130,27,70
104,113,38,150,0,133,137,105,124,84
39,108,50,40,133,0,135,169,105,107
165,69,133,76,137,135,0,81,90,176
64,164,45,130,105,169,81,0,119,44
114,90,60,27,124,105,90,119,0,102
47,173,112,70,84,107,176,44,102,0
