0,109,80,102,72,38,106,70,164,162
109,0,58,140,63,124,33,82,91,163
80,58,0,73,97,87,112,48,73,93
102,140,73,0,80,31,170,105,54,8
72,63,97,80,0,105,79,122,119,78
38,124,87,31,105,0,124,63,146,100
106,33,112,170,79,124,0,94,160,95
70,82,48,105,122,63,94,0,70,41
164,91,73,54,119,146,160,70,0,124
162,163,93,8,78,100,95,41,124,0
