0,78,106,95,161,89,105,109
78,0,75,75,169,76,55,126
106,75,0,71,50,21,109,110
95,75,71,0,69,101,88,143
161,169,50,69,0,101,147,37
89,76,21,101,101,0,103,96
105,55,109,88,147,103,0,38
109,126,110,143,37,96,38,0
