0,94,111,64,46,153,30,56
94,0,92,81,44,117,76,83
111,92,0,114,35,165,68,134
64,81,114,0,162,22,49,141
46,44,35,162,0,119,108,68
153,117,165,22,119,0,132,24
30,76,68,49,108,132,0,102
56,83,134,141,68,24,102,0
